NO ./textures/red.xpm
SO ./textures/green.xpm
WE ./textures/brick.xpm
EA ./textures/yellow.xpm
F 255,153,204
C 153,153,255

111111
100001
10N001
100001
111111
