NO ./textures/red.xpm
SO ./textures/green.xpm
WE ./textures/blue.xpm
EA ./textures/yellow.xpm

F 255,153,204
C 153,153,255

1111111111111111111111111111111111111111111111111111111111111
1000000000000000000000000000000000000000000000000000000000001
1011111111111111111111111111111111111111111111111111111111101
101000001111111111111111111111111111111111111111111000000001
101011101111111111111111111111111111111111111111111011101001
101000001111111111111111111111111111111111111111111000000001
101111111111111111111111111111111111111111111111111111111101
101111111111111111111111111111111111111111111111111111111101
101111111111111111111111111111111111111111111111111111111101
100000000000000000000000000000N00000000000000000000000000001
101111111111111111111111111111111111111111111111111111111101
100000000000000000000000000000000000000000000000000000000001
111111111111111111111111111111111111111111111111111111111101
100000000000000000000000000000000000000000000000000000000001
101111111111111111111111111111111111111111111111111111111101
100000000000000000000000000000000000000000000000000000000001
101111111111111111111111111111111111111111111111111111111101
100000000000000000000000000000000000000000000000000000000001
101111111111111111111111111111111111111111111111111111111101
100000000000000000000000000000000000000000000000000000000001
101111111111111111111111111111111111111111111111111111111101
100000000000000000000000000000000000000000000000000000000001
101111111111111111111111111111111111111111111111111111111101
100000000000000000000000000000000000000000000000000000000001
101111111111111111111111111111111111111111111111111111111101
100000000000000000000000000000000000000000000000000000000001
101111111111111111111111111111111111111111111111111111111101
100000000000000000000000000000000000000000000000000000000001
101111111111111111111111111111111111111111111111111111111101
100000000000000000000000000000000000000000000000000000000001
111111111111111111111111111111111111111111111111111111111111
