NO ./textures/red.xpm
SO ./textures/green.xpm
WE ./textures/blue.xpm
EA ./textures/yellow.xpm

F 255,153,204
C 153,153,255

1111111111111111111111111
10000000000000000N0000001
1000000000000000000000001
1001000000000000000000001
1000000000000000000000001
1000000000000000000000001
1000000000000000000000001
1111111111111111111111111
