NO ./textures/wall.xpm
SO ./textures/wall.xpm
WE ./textures/wall.xpm
EA ./textures/wall.xpm

F 80,80,80
C 210,190,160

1111111111111111111111111
1000000000000000000000001
1000000000000000000000001
1001000000000000000000001
10000000000S0000000000001
1000000000000000000000001
1000000000000000000000001
1111111111111111111111111
